##########
#S......E#
#..##..#.#
#.###..#.#
#....#####
##########
