##################################################
#S  ######        #     #            #         #
##  #  ### ######## # ### # ########## # ####### #
###  ## # # ###### ##### ####### ## # ####### # #
#### #  # #        #     #         # #   #     # #
#### ######## ####### ####### # ##### ##### ###
## #        #       #       #   #   #       # #
## ######## ####### # ##### ##### # ######### #
##        #  #       #     #       #           #
######## # # ##### ####### ####### ######### #
###### # # # #              #    #       # #
#### # # # # ### # ####### ####### ##### # #
###### #   #     #     #                E#
##################################################
