# # # # # # # # # # # # # # # #
# S . . . # . . . . . . . . . #
# # . # . # . # # . . . # . # #
# . . # . . . # . . # . . . # #
# . # # . # # # . # . # # . . #
# . # . # . . . . # . # . # . #
# . . . . # # . . . . . . . # #
# . # # . . # . # # . # . . . #
# . # . . # # . . # . # . . # #
# . . . . # . . . . # # . # . #
# . # # . # # . . # . . . . # #
# . . # . # . # # # . . . . . #
# # . . . # . . # . # . . . # #
# . . . # # . . . . # . # . . #
# # # # # # # # # # # # # # E #