###################################
S     #       #     #     #     #E#
# ### # ##### # ### # ### ## ## # #
# #   #     # #   # #   # #   # # #
# # ##### # # ### # ### # # # # # #
# #     # # #   # #   # #   # # # #
# ##### # # # # # # # # # # # # # #
#       # # # # # # # # # # # #   #
# ####### # # # # # # # # # # ### #
#       # # # # # # # # # # #     #
# ##### # # # # # # # # # # ##### #
# #     # # # #   #   # #       # #
# # ##### # # ##### # # ####### # #
#         #         #           # #
###################################
