##################################################
#S   #   #   #     #   #       #   #       #   ##
### ### ### ### ### ### ### ##### # ##### ### ###
#   #   #     # #     # #     #   #     # #   # #
# ### ##### ### ### ### ##### ########### ### # #
#   #       #   #     #   #   #         #   #   #
### ######### ### ##### ### ### ##### ##### #####
#       #   #   #       # #     #   #     #   # #
# ##### # # ##### ### ### ##### ##### ##### # ###
#     #   #     # #         #     #   #   # #  ##
##### ######### # ### ##### # ##### # # ### #####
#   # #       #   #   #     #   #   # #       # #
# # # # ##### ##### # ### ##### # ########### ###
# #   # #         # #   #       #   #    #    # #
### ### ### ##### ### ### ##### ### # # ### ### #
#       #     #         #             #       E#
##################################################
