#################################################
#S#         #           # #             #       #
# # ####### # ### ##### # # ##### ##### # # ### #
# # #     # # #   #   # #       #   #   # # #   #
# # # ### # ### ### # # # ######### # ### # ### #
#   # # # #     #   #   # #         # #   #   # #
##### # # ####### ######### ######### ####### # #
#   # # #         #       # #       #   #     # #
# # # # ########### ##### # # # ####### # ##### #
# # #   #   #         #   # # #   #   # #   # # #
# # ### # # ######### # ### # ### # # # ### # # #
# #       #           #     #   #   #       #  E#
#################################################
